1111111111111
1C0000C000011
1000011111001
100011E000P01
1111111111111