1111111111111
1C00000000011
1000011111P01
100M11E000001
1111111111111